+++++++++++++++++++
+0A               +
+A          +++++ +
+           +     +
+           + +++++
+           +   Aa+
+++++++++++++++++++
