+++++++++++++++++++++++++++++++++
+0bB   H     J      Q           +
+caA  B   C            P        +
+C          I                   +
+  F    D                       +
+  E      T       K             +
+  M         O                  +
+  L                            +
+++++++++++++++++++++++++++++++++
